############################################
#S               #            #            #
# ### ######### ### ####### ####### #####  #
#   #       #   #   #     #       #     #  #
### ####### # ### ### ### ####### # ### #  #
#   #     # #   #     # # #     # # #   #  #
# ### ### # ### ####### # # ### # # # ###  #
# #   # # #   #       #   # # # #   #   #  #
# # ### # ### ####### ##### # # ####### #  #
# #   # #   #     #   #     # #       # #  #
# ### # ### ##### # ### ##### ####### # #  #
#   # #   #     # #   #   #   #     # #    #
### # ### ##### # ### ### # ### ### # #### #
#   #   #     # #   #     #   #   #        #
# ##### # ### # ### ########### # ######## #
#     # # # # #   #           # #       #  #
##### # # # # ### # ######### # ####### #  #
#   # #   # #   # # #     #   #     #   #  #
# # # ##### ### # # # ### # ##### # ### #  #
# # #       #   #   # #   #     # #   #    #
# # ######### ####### # ####### # ### #### #
# #         #       # #       # #   #     F#
############################################
